R        1000       600

NO  img/test.XPM
SO         img/test.XPM
WE  img/test.XPM
EA       img/test.XPM

S   img/test.XPM
C   0,0     ,255
F   255     ,    0,0

111111111111111111111111111111111111111
100000000000000000000000000000000000001
100000000000000000000000000000000000001
100000000000000000000000000000000000001
100020000000000000000000000000000000001
1000000000000000N0000000000200000000001
100000000000000000000000000000000000001
100000111110000000000000000000000000001
100000000010000000000200000000000000001
100000000010000000000000000000000000001
111111111111111111111111111111111111111