R   600 600

NO  textures/
SO  textures/
WE  textures/
EA  textures/

S   textures/
F   61 61 41
C   102 153 153
H   textures/

       11111111111
    111000000000001
   10000010S1111101
   1011101111001001
   10000000000000001
   1011111111111101
   1000000000100001
   111111111111111
