R    900    600
NO  ./img/WALL0.XPM
SO    ./img/WALL3.XPM
WE   ./img/test.XPM
EA    ./img/WALL3.XPM

S    ./img/test.XPM
C    33 ,   33,   33
F    66 ,   66 ,   66

1111111
10222211
1000001
1000001
1000101
11111111

1111111
10222211
1000001
1000001
100N101
11111111